111111111111
10010000000C
100001111100
1P00111E0000
111111111111
