11111111111111111111111111111
1E0000000000000C00000C0000001
10100101001000001010010000001
10100100111010100010010000001
1P0000001C10C0000000000000001
11111111111111111111111111111
