1111111111111
1001000E000C1
1100011111001
1P10110000001
1111111111111
