111111111111111111111111111111111111111111111111111111111111
10C000000000001000000010000000000000000000000000000000000001
1000000000000000000C0010000000000000000000000000000000000001
1101110000111100C0000000000000000000000000000000000000000001
1E0000000011110000000010000000000000000000000000000000000001
1111111100011100P0000010000000000000000000000000000000000001
100000000000010000000010000000000000000000000000000000000001
10C000000000010000000010000000000000000000000000000000000001
1101110000111100000C0010000000000000000000000000000000000001
10000000000C000000000010000000000000000000000000000000000001
10000000000C000000000010000000000000000000000000000000000001
10000000000C000000000010000000000000000000000000000000000001
10000000000C000000000010000000000000000000000000000000000001
10000000000C000000000010000000000000000000000000000000000001
10000000000C000000000010000000000000000000000000000000000001
10000000000C000000000010000000000000000000000000000000000001
10000000000C000000000010000000000000000000000000000000000001
10000000000C000000000010000000000000000000000000000000000001
10000000000C000000000010000000000000000000000000000000000001
10000000000C000000000010000000000000000000000000000000000001
10000000000C000000000010000000000000000000000000000000000001
10000000000C000000000010000000000000000000000000000000000001
10000000000C000000000010000000000000000000000000000000000001
10000000000C000000000010000000000000000000000000000000000001
10000000000C000000000010000000000000000000000000000000000001
10000000000C000000000010000000000000000000000000000000000001
10000000000C000000000010000000000000000000000000000000000001
10000000000C000000000010000000000000000000000000000000000001
10000000000C000000000010000000000000000000000000000000000001
10000000000C000000000010000000000000000000000000000000000001
10000000000C000000000010000000000000000000000000000000000001
10000000000C000000000010000000000000000000000000000000000001
10000000000C000000000010000000000000000000000000000000000001
111111111111111111111111111111111111111111111111111111111111
